stranger: yabancı
include: içermek
in fact: aslında
explanation: açıklama
structure: yapı
express: ifade etmek
as well: ayrıca
novel: roman
reputation: saygınlık
briefly: kısaca
conclud: sonuç
don't mention it: bir şey değil
trainee: stajyer
almost: neredeyse
appointment: randevu
organized: düzenli
afford: gücü yetmek
suppose: sanmak
pole: kutup
hole: delik
appear: ortaya çıkmak
crevasse: yarık
bacon: pastırma
favour: iyilik
take exam: sınava girmek
permanent: kalıcı
as soon as: en kısa sürede
temporary: geçici
evidence: kanıt
attention: dikkat
strangely: tuhaf bir şekilde
